........................................
..............
......
..........................

				
........................#############
........................#############
........................##.........##
........................##.........##
........................##.........##
........................##....!....##
........................##.........##
........................##.........##
...#######################.........##
...................................##
...................................##
....@..............................##
...................................##
...................................##
...#######################.........##
........................##.........##
........................##.........##
........................##.........##
........................##.........##
........................##.........##
........................##.........##
........................##.........##
........................##....!....##
........................##.........##
........................##.........##
........................#############
........................#############
.
.......................................







